000000000000000000000000000000
000000000000111100000000000000
000000000001111110000000000000
000000000011111111000000000000
000000000111111111100000000000
000000001111111111110000000000
000000011111111111111000000000
000000111111111111111100000000
000000000000000000000000000000
000000000000000000000000000000
000000000000222200000000000000
000000000022222200000000000000
000000000222222220000000000000
000000002222222222000000000000
000000022222222222200000000000
000000000000000000000000000000
000000000000000000000000000000
000000000000000000000000000000