000000000000010000000000000000
000000000000111000000000000000
000000000001111100000000000000
000000000011111110000000000000
000000000111111111000000000000
000000000011111110000000000000
000000000001111100000000000000
000000000000111000000000000000
000000000000010000000000000000
000000000000000000000000000000
000000000000020000000000000000
000000000000222000000000000000
000000000002222200000000000000
000000000022222220000000000000
000000000002222200000000000000
000000000000222000000000000000
000000000000020000000000000000
000000000000000000000000000000